############
#          #
# O        #
#    #     #
#      K   #
#          #
#  P       #
#       O  #
#   N      #
#          #
#          #
############